%%%%%%%%%%%%%%%%%%%%
%                  %
%                  %
%                  %
%                  %
%                  %
%                  %
%    % %           %
%%%%%% %           %
%      %           %
%      %           %
%      %           %
%      %           %
%      %           %
%%%%%% %           %
% P    %    .      %
%%%%%%%%%%%%%%%%%%%%