%%%%%%%%%%%%%%%%%%%%
%                  %
%                  %
%                  %
%                  %
%                  %
%                  %
%    % %           %
%%%%%% %        P  %
%      %           %
%      %           %
%      %           %
%      %           %
%      %           %
%%%%%% %           %
%    . %           %
%%%%%%%%%%%%%%%%%%%%