%%%%%%%%%%%%%%%%%%%%
%                  %
%                  %
%                  %
%                  %
%                  %
%                  %
%    % %       .   %
%%%%%% %           %
%                  %
%      %           %
%      %           %
%      %           %
%      %           %
%%%%%% %           %
% P    %           %
%%%%%%%%%%%%%%%%%%%%