%%%%%%%%%%%%%%%%%%%%
%                  %
%                  %
%                  %
%               .  %
%  %%%%%%%%%%%%%%%%%                
%                  %
%%%%%%%%%%%%       %
%                  %
%                  %
%    %%%%%%%%%%%%%%%              
%                  %
%       %          %
%       %          %
%       %          %
%       %          %
%       %          %
%%%%%%%%%          %
%P                 %
%%%%%%%%%%%%%%%%%%%%